111111111
10P0C1101
100C00C01
100000001
100111001
1000C00E1
111111111
